00000000000000000000000000000000000000000000000000000000000000000000000000000000000000000000000000000000000000000000000000000000000000000
00000000000000000000000000000000000000000000000000000000000000000000000000000000000000000000000000000000000000000000000000000000000000000
00000000000000000000000000000000000000000000000000000000000000000000000000000000000000000000000000000000000000000000000000000000000000000
00000000000000000000000000000000000000000000000000000000000000000000000000000000000000000000000000000000000000000000000000000000000000000
00000000000000000000000000000000000000000000000000000000000000000000000000000000000000000000000000000000000000000001111100000000000000000
00000000000000000000000000000000000000000000000000000000000000000000000000000000000000000000000000000000000000000011111100000000000000000
00000000000000000000000000000000000000000000000000000000000000000000000000000000000000000000000000000000000000000111111100000000000000000
00000000000000000000000000000000000000000000000000000000000000000000000000000000000000000000000000000000000000000111111100000000000000000
00000000000000000000000000000000000000000000000000000000000000000000000000000000000000000000000000000000000000000011110000000000000000000
00000000000000000000000000000000000000000000000000000000000000000000000000000000000000000000000000000000000000000000000000000011110000000
00000000000000000000000000000000000000000000000000000000000000000000000000000000000000000000000000000000000000000001110000000011110000000
00000000000000000000000000000000000000000000000000000000000000000000000000000000000000000000000000000000000000000001110000000011110000000
00000000000000000000000000000000000000000000000000000000000000000000000000000000000000000000000011111100000000000111110000000001110000000
00000000000000000000000000000000000000000000000000000000000000000000000000000000000000000000111111111100000000011111110000000000000000000
00000000000000000000000000000000000000000000000000000000000000000000000000000000000000001111111111111100000000011111000000000111100000000
00000000000000000000000000000000000000000000000000000000000000000000000000000000000011111111111111111100000000011111000000000111111110000
00000000000000000000000000000000000000000001111000000000000000000000000000000000011111111111111111111100000000011111000000000111111110000
00000000000000000000000000000000000000000001111000000000000000000000000000000111111111111111111111111110000000001111000000000111111110000
00000000000000000000000000000000000000000001111000000000000000000000000111111111111111111111111111111110000000001111000000000011111100000
00000000000000000000000000000000000000000001111000000000000000000011111111111111111111111000111111111111100000111111000000000000000000000
00000000000000000111000000000000000000000000110000000000011111111111111111111111111110000000111111111111100000111011111100000000000000000
00000000000000111111111111100011111111100000000011111111111111111111111111111111111100000000111111111111110000111111111100000000000000000
00000000000000111111111111110011111111111111111111111111111111111111111111111111100000000000111111111111110011111111111100000000000000000
00000000000001111111111111111111111111111111111111111111111111111111110000011111110000000000011111111111110011111111111100000000000000000
00000000000001111111111111111111111111111111111111111111111111111111100000001111110000000000011111111111111111111111111000000000000000000
00000000000001111111111111111111111111111111111111111110000001111110000000001111110000000000011111111111111111110001111000000000000000000
00000000000000111111111111111111111111111111011111110000000001111110000000001111110000000000011111111111111110000000000000000000000000000
00000000000011111111111000111111111110000000001111110000000001111110000000001111110000000000011111111111111110000000000000000000000000000
00000000000111111111111000111111111110000000001111110000000001111110000000001111111000000000011111111111111111000000000000000000000000000
00000000000111111110000000111111111110000000001111110000000001111110000000001111111000000000001111111111111111000000000000000000000000000
00000000001111111110000000111111111111100000001111110000000000111110000000001111111100000000001111111111111111000000000000000000000000000
00000000001111111100000000011111111111110000001111100000000000111110000000001111111111100000000000000011111111100000000000000000000000000
00000000001111111100000000011111111111110000001111100000000001111110000000001111111111110000000000000001111111111000000000000000000011111
00000000011111111100000000011111111111110000001111110000000011111111000000000111111111110000000000000000011111111000000000000000000011111
00000000011111111000000000011111111011100020001111110000000011111111000000000011111111110000000000000000001111111100000000000000000011111
11100000111111111000000000111111111000000000001111111000000011111111111000000011111111100000000000000000000111111110000000000000001111111
11110000111111110000000111111111111100000000001111111000000011111111111000000011111100000000000000000000000001111111000000000000001111111
11111111111111110000000111111111111111100000001111111111000001111111111000000000000000000000000000000000000001111111100000000000001111000
11111111111111110000000111111111111111100000001111111111000001111111111000000000000000000000000000000000000000111111110000000000001111100
11111111111100000000000111111111111111100000001111111111000000111111100000000000000000000000000000000000000000011111111000000000001111100
11111111111100000000000000001111111111100000001111111110000000000000000000000000000000000000000000000000000000001111111000001111000111100
11111111111100000000000000000000000000000000000000000000000000000000000000000000000000000000000000000000000000000111111000001111001110000
11111111111000000000000000000000000000000000000000000000000000000000000000000000000000000000000000000000000000000011111000001111111111000
11111111100000000000000000000000000000000000000000000000000000000000000000000000000000000000000000000000000000000011111111110111111111000
11111111110000000000000000000000000000000000000000000000000000000000000000000000000000000000000000000000000000000011111111111111111110000
11111111111100000000000000000000000000000000000000000000000000000000000000000000000000000000000000000000000000000001111111111111111100000
11111111111110000000000000000000000000000000000000000000000000000000000000000000000000000000000000000000000000000001111111111111110000000
00001111111110000000000000000000000000000000000000000000000000000000000000000000000000000000000000000000000000000000111111111111000000000
00000001111110000000000000000000000000000000000000000000000000000000000000000000000000000000000000000000000000000000000001111110000000000
00000001111100000000000000000000000000000000000000000000000111000000000000000000000000000000000000000000000000000000000001111110000000000
00000011111100000000000000000000000000000000000000000000001111100000000000000000000000000000000000000000000000000000000001111100000000000
00000011111100000000000000000000000000000000000000000001111111100000000000000000000000000000000000000000000000000000000001111100000000000
00000011111000000000000000000000000000000000000000000001111111110000000000000000000001111111000000000000000000000000000011111100000000000
00000111111000000000000000000000000000000000000000000001111111110000000000000000000011111111100000000000000000000000000111111100000000000
00000111111100000000000000000000000000000000000000000001111111110000000000000000000011111111100000000000000000000000001111111100000000000
00000111111111100000000000000000000000000000000000000001111111111000000000000000000011111111100000000000000000000000011111110000000000000
00000111111111111111000000000000000000000000000000000000000011111000000000000000000011111111100000000000000000000000111111110000000000000
00000001111111111111110000000000000000000000000000000000000001111100000000000000000011111111100000000000000000000001111111100000000000000
00000000001111111111111100000000000000000000000000000000000011111100000000000000000011111111100000000000000000000011111111000000000000000
00000000000011111111111111100000000000000000000000000000001111111100000000000000000011111111100000000000000000000111111100000000000000000
00000000000000011111111111111000000000000000000000000000001111111100000000000000000001111111000000000000000000001111111100000000000000000
00000000000000000111111111111111110000000000000000000000001111111000000000000000000000000000000000000000000000011111111100000000000000000
00000000000000000000111111111111111000000000000000000000001111100000000000000000000000000000000000000000000000111111111100000000000000000
00000000000000000000000111111111111110000000000000000000000000000000000000000000000000000000000000000000000001111111111000000000000000000
00000000000000000000000001111111111111110000000000000000000000000000000000000000000000000000000000000000000011111111000000000000000000000
00000000000000000000000000001111111111111100000000000000000000000000000000000000000000000000000000000000000111111110000000000000000000000
00000000000000000000000000000011111111111111000000000000000000000000000000000000000000000000000000000000001111111100000000000000000000000
00000000000000000000000000000000011111111111111000000000000000000000000000000000000000000000000000000000011111111000000000000000000000000
00000000000000000000000000000000000111111111111110000000000000000000000000000000000000000000000000000001111111110000000000000000000000000
00000000000000000000000000000000000000111111111111110000000000000000000000000000000000000000000000000001111111100000000000000000000000000
00000000000000000000000000000000000000001111111111111110000000000000000000000000000000000000000000000011111111000000000000000000000000000
00000000000000000000000000000000000000000001111111111111110000000000000000000000000000000000000000000011111110000000000000000000000000000
00000000000000000000000000000000000000000000011111111111111100000000000000000000000000000000000000000011111100000000000000000000000000000
00000000000000000000000000000000000000000000000011111111111111000000000000000000000000000000000000000111111000000000000000000000000000000
00000000000000000000000000000000000000000000000000111111111111111000000000000000000000000000000000000111110000000000000000000000000000000
00000000000000000000000000000000000000000000000000000111111111111111000000000000000000000000000000001111110000000000000000000000000000000
00000000000000000000000000000000000000000000000000000000111111111111110000000000000000000020000000001111100000000000000000000000000000000
00000000000000000000000000000000000000000000000000000000001111111111111110000000000000000000000000001111100000000000000000000000000000000
00000000000000000000000000000000000000000000000000000000000011111111111111100000000000000000000000011111100000000000000000000000000000000
00000000000000000000000000000000000000000000000000000000000000011111111111111100000000000000000000011111000000000000000000000000000000000
00000000000000000000000000000000000000000000000000000000000000000111111111111111100000000000000000111111000000000000000000000000000000000
00000000000000000000000000000000000000000000000000000000000000000000111111111111111000000000000000111110000000000000000000000000000000000
00000000000000000000000000000000000000000000000000000000000000000000001111111111111110000000000000111110000000000000000000000000000000000
00000000000000000000000000000000000000000000000000000000000000000000000001111111111111110000000001111110000000000000000000000000000000000
00000000000000000000000000000000000000000000000000000000000000000000000000011111111111111100000001111100000000000000000000000000000000000
00000000000000000000000000000000000000000000000000000000000000000000000000000011111111111111100011111100000000000000000000000000000000000
00000000000000000000000000000000000000000000000000000000000000000000000000000000111111111111111011111000000000000000000000000000000000000
00000000000000000000000000000000000000000000000000000000000000000000000000000000001111111111111111111000000000000000000000000000000000000
00000000000000000000000000000000000000000000000000000000000000000000000000000000000011111111111111111000000000000000000000000000000000000
00000000000000000000000000000000000000000000000000000000000000000000000000000000000000011111111111110000000000000000000000000000000000000
00000000000000000000000000000000000000000000000000000000000000000000000000000000000000000011111111110000000000000000000000000000000000000
00000000000000000000000000000000000000000000000000000000000000000000000000000000000000000001111111110000000000000000000000000000000000000
00000000000000000000000000000000000000000000000000000000000000000000000000000000000000000000001111100000000000000000000000000000000000000
00000000000000000000000000000000000000000000000000000000000000000000000000000000000000000000000000000000000000000000000000000000000000000
00000000000000000000000000000000000000000000000000000000000000000000000000000000000000000000000000000000000000000000000000000000000000000
