00000000000000000000000000000000000000000000000000000000000000000000000000000000000000000000000000000000000000000000000000000000000000000
00000000000000000000000000000000000000000000000000000000000000000000000000000000000000000000000000000000000000000000000000000000000000000
00000000000000000000000000000000000000000000000000000000000000000000000000000000000000000000000000000000000000000000000000000000000000000
00000000000000000000000000000000000000000000000000000000000000000000000000000000000000000000000000000000000000000001111110000000000000000
00000000000000000000000000000000000000000000000000000000000000000000000000000000000000000000000000000000000000000111111110000000000000000
00000000000000000000000000000000000000000000000000000000000000000000000000000000000000000000000000000000000000000111111110000000000000000
00000000000000000000000000000000000000000000000000000000000000000000000000000000000000000000000000000000000000000111111110000000000000000
00000000000000000000000000000000000000000000000000000000000000000000000000000000000000000000000000000000000000000111111110000000000000000
00000000000000000000000000000000000000000000000000000000000000000000000000000000000000000000000000000000000000000111111100000011111000000
00000000000000000000000000000000000000000000000000000000000000000000000000000000000000000000000000000000000000000111111000000011111000000
00000000000000000000000000000000000000000000000000000000000000000000000000000000000000000000000000000000000000000011111000000011111000000
00000000000000000000000000000000000000000000000000000000000000000000000000000000000000000000000011111100000000001111111000000011111000000
00000000000000000000000000000000000000000000000000000000000000000000000000000000000000000000111111111100000000111111111000000011111000000
00000000000000000000000000000000000000000000000000000000000000000000000000000000000000001111111111111100000000111111111000000111111000000
00000000000000000000000000000000000000000000000000000000000000000000000000000000000011111111111111111110000000111111111000001111111110000
00000000000000000000000000000000000000000001111000000000000000000000000000000000111111111111111111111110000000111111100000001111111111000
00000000000000000000000000000000000000000011111100000000000000000000000000000111111111111111111111111111000000111111100000001111111111000
00000000000000000000000000000000000000000011111100000000000000000000000011111111111111111111111111111111000000011111100000001111111111000
00000000000000000000000000000000000000000011111100000000000000000011111111111111111111111111111111111111100000011111100000000111111111000
00000000000000000000000000000000000000000011111100000000011111111111111111111111111111111111111111111111100001111111111100000000000000000
00000000000000111111111111110011111111100011111111111111111111111111111111111111111111110001111111111111110001111111111110000000000000000
00000000000001111111111111110111111111111111111111111111111111111111111111111111111110000001111111111111110111111111111110000000000000000
00000000000001111111111111111111111111111111111111111111111111111111111111111111111100000000111111111111110111111111111110000000000000000
00000000000001111111111111111111111111111111111111111111111111111111111111111111111000000000111111111111111111111111111110000000000000000
00000000000001111111111111111111111111111111111111111111111111111111110000011111111000000000111111111111111111111111111100000000000000000
00000000000001111111111111111111111111111111111111111111111111111111100000011111111000000000111111111111111111111111111100000000000000000
00000000000111111111111111111111111111111111111111111110000011111111000000011111111000000000011111111111111111111011111100000000000000000
00000000000111111111111111111111111111111000011111111000000011111111000000011111111100000000011111111111111111100000000000000000000000000
00000000001111111111111101111111111111000000011111110000000001111111000000011111111100000000011111111111111111100000000000000000000000000
00000000001111111111111001111111111111000000011111110000000001111111000000011111111100000000011111111111111111100000000000000000000000000
00000000011111111111000001111111111111111000011111110000000001111111000000011111111111100000011111111111111111110000000000000000000000000
00000000011111111110000001111111111111111000011111110000000001111111000000011111111111110000011111111111111111111100000000000000000011111
00000000011111111110000000111111111111111000011111111000000111111111000000011111111111110000000000000111111111111100000000000000000111111
00000000111111111110000000111111111111111000011111111000000111111111100000001111111111110000000000000001111111111110000000000000000111111
00000000111111111100000000111111111111111020011111111000000111111111111100001111111111110000000000000000111111111111000000000000011111111
11110001111111111100001111111111111100000000011111111000000111111111111100000111111111110000000000000000001111111111100000000000011111111
11111001111111111000001111111111111111110000011111111111000111111111111100000111111111100000000000000000000111111111110000000000011111111
11111111111111111000001111111111111111110000011111111111100011111111111100000111111000000000000000000000000011111111111000000000011111111
11111111111111111000001111111111111111110000011111111111100011111111111100000000000000000000000000000000000001111111111100000000011111100
11111111111111111000001111111111111111110000011111111111100011111111111100000000000000000000000000000000000000111111111100001111011111100
11111111111110000000001111111111111111110000011111111111100001111100000000000000000000000000000000000000000000011111111100011111101111100
11111111111110000000000000000000011111110000011111111110000000000000000000000000000000000000000000000000000000001111111100011111111111100
11111111111100000000000000000000000000000000000000000000000000000000000000000000000000000000000000000000000000000111111111111111111111000
11111111111000000000000000000000000000000000000000000000000000000000000000000000000000000000000000000000000000000111111111111111111111000
11111111111110000000000000000000000000000000000000000000000000000000000000000000000000000000000000000000000000000111111111111111111111000
11111111111110000000000000000000000000000000000000000000000000000000000000000000000000000000000000000000000000000111111111111111111111000
11111111111110000000000000000000000000000000000000000000000000000000000000000000000000000000000000000000000000000011111111111111111100000
11111111111110000000000000000000000000000000000000000000000000000000000000000000000000000000000000000000000000000011111111111111110000000
00001111111110000000000000000000000000000000000000000000000000000000000000000000000000000000000000000000000000000001111111111111000000000
00000011111110000000000000000000000000000000000000000000011111100000000000000000000000000000000000000000000000000000000011111111000000000
00000111111110000000000000000000000000000000000000000001111111110000000000000000000000000000000000000000000000000000000011111110000000000
00000111111110000000000000000000000000000000000000000011111111110000000000000000000001111111000000000000000000000000000011111110000000000
00000111111100000000000000000000000000000000000000000011111111111000000000000000000111111111100000000000000000000000000111111110000000000
00001111111110000000000000000000000000000000000000000011111111111000000000000000000111111111110000000000000000000000001111111110000000000
00001111111111100000000000000000000000000000000000000011111111111100000000000000000111111111110000000000000000000000111111111110000000000
00001111111111111100000000000000000000000000000000000011111111111100000000000000000111111111110000000000000000000001111111111100000000000
00001111111111111111110000000000000000000000000000000001111111111110000000000000000111111111110000000000000000000011111111111000000000000
00000111111111111111111100000000000000000000000000000000000111111110000000000000000111111111110000000000000000000111111111110000000000000
00000001111111111111111111100000000000000000000000000000001111111110000000000000000111111111110000000000000000001111111111100000000000000
00000000011111111111111111111100000000000000000000000000011111111110000000000000000111111111110000000000000000001111111111000000000000000
00000000000011111111111111111111100000000000000000000000011111111110000000000000000111111111100000000000000000011111111110000000000000000
00000000000000011111111111111111111000000000000000000000011111111110000000000000000011111111000000000000000000111111111110000000000000000
00000000000000000111111111111111111110000000000000000000011111111000000000000000000000000000000000000000000001111111111110000000000000000
00000000000000000000111111111111111111110000000000000000011111100000000000000000000000000000000000000000000011111111111110000000000000000
00000000000000000000000111111111111111111110000000000000000000000000000000000000000000000000000000000000000111111111100000000000000000000
00000000000000000000000001111111111111111111000000000000000000000000000000000000000000000000000000000000011111111111100000000000000000000
00000000000000000000000000011111111111111111111000000000000000000000000000000000000000000000000000000000111111111111000000000000000000000
00000000000000000000000000000011111111111111111111000000000000000000000000000000000000000000000000000001111111111110000000000000000000000
00000000000000000000000000000000011111111111111111110000000000000000000000000000000000000000000000000011111111111100000000000000000000000
00000000000000000000000000000000000111111111111111111110000000000000000000000000000000000000000000000011111111111000000000000000000000000
00000000000000000000000000000000000000111111111111111111110000000000000000000000000000000000000000000111111111110000000000000000000000000
00000000000000000000000000000000000000001111111111111111111100000000000000000000000000000000000000000111111111000000000000000000000000000
00000000000000000000000000000000000000000001111111111111111111100000000000000000000000000000000000001111111110000000000000000000000000000
00000000000000000000000000000000000000000000011111111111111111111000000000000000000000000000000000001111111100000000000000000000000000000
00000000000000000000000000000000000000000000000011111111111111111110000000000000000000000000000000001111111000000000000000000000000000000
00000000000000000000000000000000000000000000000000111111111111111111110000000000000000000000000000011111111000000000000000000000000000000
00000000000000000000000000000000000000000000000000000111111111111111111110000000000000000000000000011111110000000000000000000000000000000
00000000000000000000000000000000000000000000000000000001111111111111111111100000000000000000000000111111110000000000000000000000000000000
00000000000000000000000000000000000000000000000000000000001111111111111111111100000000000000000000111111110000000000000000000000000000000
00000000000000000000000000000000000000000000000000000000000011111111111111111111100000000000000000111111100000000000000000000000000000000
00000000000000000000000000000000000000000000000000000000000000011111111111111111111000000000000001111111100000000000000000000000000000000
00000000000000000000000000000000000000000000000000000000000000000111111111111111111110000000000001111111100000000000000000000000000000000
00000000000000000000000000000000000000000000000000000000000000000000111111111111111111110000000011111111000000000000000000000000000000000
00000000000000000000000000000000000000000000000000000000000000000000001111111111111111111100000011111111000000000000000000000000000000000
00000000000000000000000000000000000000000000000000000000000000000000000001111111111111111111100011111110000000000000000000000000000000000
00000000000000000000000000000000000000000000000000000000000000000000000000011111111111111111111111111110000000000000000000000000000000000
00000000000000000000000000000000000000000000000000000000000000000000000000000111111111111111111111111110000000000000000000000000000000000
00000000000000000000000000000000000000000000000000000000000000000000000000000000111111111111111111111100000000000000000000000000000000000
00000000000000000000000000000000000000000000000000000000000000000000000000000000001111111111111111111100000000000000000000000000000000000
00000000000000000000000000000000000000000000000000000000000000000000000000000000000011111111111111111000000000000000000000000000000000000
00000000000000000000000000000000000000000000000000000000000000000000000000000000000000111111111111111000000000000000000000000000000000000
00000000000000000000000000000000000000000000000000000000000000000000000000000000000000000111111111111000000000000000000000000000000000000
00000000000000000000000000000000000000000000000000000000000000000000000000000000000000000001111111110000000000000000000000000000000000000
00000000000000000000000000000000000000000000000000000000000000000000000000000000000000000000001111100000000000000000000000000000000000000
00000000000000000000000000000000000000000000000000000000000000000000000000000000000000000000000000000000000000000000000000000000000000000
